NO ./Blue2.xpm
SO ./Grey18.xpm
EA ./Door3.xpm
WE ./Brown7.xpm
F 220,100,0
C 225,30,0

11111111111111111111111111111111111111111111111111111111111111111111111111111111111111111111111111111111111111111111111111111
10000000000000000000000000000000000000000000000000000000000000000000000000000000000000000000000000000000000000000000000000001
10000000011111111111000111111111001000000000011111111111111111111111111111111111111111111111111111111111111111111111111111111
1000000001000000000000000000000000000000000001
1000000001000000000000001111110000100000000001
10000000010000100000000000000W0000100000000001
1000000001111011110000001111110000000000000001
1000000001000000000000000000000000000000000001
1000000000000000000000000000000000100000000001
1000000000000000011111100000000000100000000001
1000000001000000000000000000000000100000000001
1000000001111111111011111111110111100000000001
1000000000000000000000000000000000000000000001
1000000000000000000000000000000000000000000001
1111111111111111111111111111111111111111111111
