NO ./WallPack/Black5.bmp
SO ./WallPack/Brown5.bmp
EA ./WallPack/Brown18.bmp
WE ./WallPack/Brown17.bmp
F 220,100,0
C 225,30,0

1111111111111111111111111111111111111111111111
1000000000000000000000000000000000000000000001
1000000000000000000000000000000000000000000001
1000000000000000000000000000000000000000000001
1000000000000000000000001111110000000000000001
10000000000000000000000000000W0000000000000001
1000000000000000000000001111110000000000000001
1000000000000000000000000000000000000000000001
1000000000000000000000000000000000000000000001
1000000000000000000000000000000000000000000001
1000000000000000000000000000000000000000000001
1000000000000000000000000000000000000000000001
1000000000000000000000000000000000000000000001
1000000000000000000000000000000000000000000001
1111111111111111111111111111111111111111111111
