NO ./WallPack/Blue2.xpm
SO ./WallPack/Grey18.xpm
EA ./WallPack/Door3.xpm
WE ./WallPack/Brown7.xpm
F 128,128,128
C 135,206,235

11111
10001
 1N1
  1                   
