NO ./WallPack/Black5.bmp
SO ./WallPack/Brown5.bmp
EA ./WallPack/Brown18.bmp
WE ./WallPack/Brown17.bmp
F 220,100,0
C 225,30,0

11111
10001
 1N1
  1                   
