NO ./WallPack/Blue5.xpm
SO ./WallPack/Blue5.xpm
EA ./WallPack/Blue5.xpm
WE ./WallPack/Blue5.xpm
DO ./WallPack/Blue1.xpm
CL ./WallPack/cloud.xpm
F 33,33,33
C 89,1,238

 1111111111111111111111111111111111111111111111111111111111111111111111111111111111111111111111111111111111111111111111111111
10000000000000000000000000000000000000000000000000000000000000000000000000000000000000000000000000000000000000000000000000001
10000000011111111111000111111111001000000000011111111111111111111111111111111111111111111111111111111111111111111111111111111
1000000001000000000000000000000000000000000001
1000000001000000000000001111110000100000000001
1000000001000010000000000000000000100000000001
1000000000001011110000001111110000000000000001
10000000000000000000000000000000000000000001
1000E01210000000000000000000000000100000000001
1000000000000000011111100000000000100000000001
1000000100000000000000000000000000100000000001
1000001200000111111011111111110111100000000001
1000000100000000000000000000000000000000000001
1000000000000000000000000000000000000000000001
1111111111111111111111111111111111111111111111
