NO ./cub3d_mand/WallPack/Blue5.xpm
SO ./cub3d_mand/WallPack/Blue5.xpm
EA ./cub3d_mand/WallPack/Blue5.xpm
WE ./cub3d_mand/WallPack/Blue5.xpm
F 33,33,33
C 89,1,238

 1111111111111111111111111111111111111111111111111111111111111111111111111111111111111111111111111111111111111111111111111111
10000000000000000000000000000000000000000000000000000000000000000000000000000000000000000000000000000000000000000000000000001
10000000011111111111000111111111001000000000011111111111111111111111111111111111111111111111111111111111111111111111111111111
1000000001000000000000000000000000000000000001
1000000001000000000000001111110000100000000001
1000000001000010000000000000000000100000000001
1000000000001011110000001111110000000000000001
1000000000000000000000000000000000000000000001
1000E01010000000000000000000000000100000000001
1000000000000000011111100000000000100000000001
1000000100000000000000000000000000100000000001
1000001000000111111011111111110111100000000001
1000000100000000000000000000000000000000000001
1000000000000000000000000000000000000000000001
1111111111111111111111111111111111111111111111
